111111111111111111111111111111111
100011100011100011100011100010001
1010001000000000001000001001000011111   1
100000100111111111100100100000001
100000100100000000100100100000001
100000100100000000100100100000001
100000100100000000100100100000001
100000100111111111100100100000001111
100000100000000000000100100000001
100000100011100011100011100000001
100000100011100011100011100000001
100000100100100100100100100000001
 1 100000100100100100100100100001
100000100100100100100100100000001
100000100000000000000100100000001
10000010011111111110010010000000111
100000100100000000100100100000001
100000100100000000100100100000001
100000100100000000100100100000001
100000100100000000100100100000001
100000100111111111100100100000001
100000100000000000000100100000001
100000100011100011100011100000001
100000100011100011100011100000001
100000100100100100100100100000001
100000100100100100100100100000001
100000100100100100100100100E00011
100000100000000000000100100000111
100000111111111111111100100001111
100000000000000000000000000011111
111111111111111111111111111111111