111111111111111
100000000000001
100000000000001
100000000000001
100000001100001
100000000000001
101110000000001
1000000E0000001
100000000000001
100000000000001
100000000001111
100000000000001
100000000000001
100000100000001
111111111111111