1111111111111111111
1000000000000000001
1000000000000000001
1000000000000011111
100000001100001
10000000000000111111111111
10111000000000000000000001
1000000N000000000000000001
10000000000000000000000001
10000000000000011111111111
100000000001111
100000000000001111111111111111111111111
100000000000000000000000000000000000001
100000100000000000000000000000000000001
111111111111111111111111111111111111111