random shit before everything

what is this garbage

1 1 1 1
1    1
1    1
100101
101011
1100N  11
111101