F 255, ,100 , 0
C 225,30,0

1 1 1 1
1    1
1    1
100101
101011
1100N  11
111111
