111111 111111111111111111111111111111111
100101
101001
1100N1
111111
