
            111111 111111111111111111111  111111111111111111111111111111111111111111
100101 1


101001 1
1100N1 1
111111 1


                111111111111                                                            1
                100000000001
                10000N000001111111111111
                111000000000000000000001
                  1000000000000000000001
                  1111111111111111111111