111111
1    1
1    1
100101
10101
1100N11
111111