F    255, 10, 0

C 225,30,0

SO textures/wall_SO.xpm
WE textures/wall_WE.xpm
NO textures/wall_NO.xpm
EA textures/wall_EA.xpm

1111111111111111
1000000000000001
1000000000000011
1000000000000001
1000000011000011
1000000000000011
1011100000000011
1000000E00000011
1000000000000011
1000000000000011
1000000000011111
1000000000000011
1000000000000011
1000001000000011
1111111111111111