F    255, 10, 0

C 225,30,0

SO textures/wall_SO.xpm
WE textures/wall_WE.xpm
NO textures/wall_NO.xpm
EA textures/wall_EA.xpm


111111
1    1
1    1
100101
101011
1100N1
111111