F    255, 10, 0

C 0,30,255

SO textures/wall_SO.xpm
WE textures/wall_WE.xpm
NO textures/wall_NO.xpm
EA textures/wall_EA.xpm

11111
11111
11N11
11111
11111